w,w,w,w,w,w,w,w,w,w,w,w,w,w,w,w,w,w,w,w,w,w,w,w,w,w,w,w,w,w,w,w,w,w,w,w,w,w,w,w,w,w,w,w,w,w,w,w,w,w,w,w,w,w,w,w,w,w,w,w
w,w,m,m,m,m,m,m,m,m,m,m,m,m,m,m,m,m,m,m,m,m,m,m,m,m,m,m,m,m,m,m,m,m,m,m,m,m,m,m,w,w,s,w,w,s,w,w,s,w,w,k,w,w,m,m,n,m,w,w
w,m,r,r,r,r,r,r,r,r,r,r,r,r,r,r,r,r,r,r,r,r,r,r,r,r,r,r,r,r,r,r,r,r,r,r,r,r,r,r,m,p,r,p,p,r,p,p,r,d,p,r,c,m,r,r,a,r,m,w
w,m,r,m,m,m,m,m,m,m,m,m,m,m,m,m,m,m,r,m,m,m,m,m,m,m,m,m,m,m,m,m,a,m,m,m,m,m,m,r,m,p,r,c,p,r,e,p,r,c,p,r,p,m,r,b,t,r,m,w
w,m,r,m,m,m,m,m,m,m,n,m,m,m,m,m,m,m,r,m,m,n,m,m,m,m,m,m,m,m,m,n,r,m,g,g,g,g,m,r,m,p,r,p,p,r,p,p,r,p,p,r,p,m,r,r,r,r,m,w
w,m,r,r,r,r,r,r,r,r,r,r,r,r,r,r,r,r,r,r,r,r,r,r,r,r,r,r,r,r,r,r,r,m,m,m,m,n,m,r,m,p,r,c,p,r,p,d,r,p,e,r,p,m,m,r,m,m,w,w
w,m,r,m,m,m,r,m,m,m,r,m,m,m,m,n,m,m,r,m,m,m,r,m,m,r,m,m,m,m,m,m,r,r,r,r,r,r,r,r,r,r,r,r,r,r,r,r,r,r,r,r,r,r,r,r,r,5,m,w
w,m,r,m,g,n,r,m,g,n,r,m,m,m,m,m,m,m,r,m,g,n,r,m,m,r,m,g,g,g,g,m,r,m,m,m,m,m,m,m,m,m,r,m,m,m,m,m,m,m,m,r,m,n,m,m,m,r,m,w
w,m,r,m,g,m,r,m,g,m,r,r,r,r,r,r,r,r,r,m,g,m,r,m,m,r,m,g,g,g,g,m,r,m,g,g,g,g,g,g,g,m,r,m,g,g,g,g,g,g,m,r,m,m,m,m,m,r,m,w
w,m,r,m,g,m,r,m,g,m,r,m,m,m,m,m,m,m,r,m,g,m,r,m,m,r,m,g,g,g,g,m,r,n,g,g,g,m,m,m,m,m,r,m,m,m,n,m,m,m,m,r,r,r,r,r,a,r,n,w
w,m,r,m,g,m,a,m,g,m,r,m,n,m,m,m,m,m,r,m,g,m,r,n,m,r,m,g,g,g,r,r,r,r,r,g,g,r,r,r,r,r,r,r,r,r,r,r,r,r,r,r,m,m,m,m,m,r,m,w
w,m,r,m,g,m,r,m,g,m,r,r,r,r,r,r,r,r,r,m,g,m,r,m,m,r,m,g,g,r,r,g,g,g,a,r,g,m,m,m,n,m,r,m,m,m,m,m,m,m,m,r,m,m,m,n,m,r,m,w
w,m,r,m,g,m,r,m,g,m,r,m,m,m,m,m,m,m,r,m,g,m,r,n,m,r,m,g,r,r,g,g,t,g,g,r,r,g,g,g,g,m,r,m,g,g,g,g,g,g,m,r,r,r,r,r,r,r,m,w
w,m,r,m,m,m,r,m,m,m,r,m,m,m,m,m,n,m,r,m,m,m,r,m,m,r,m,m,r,g,g,g,g,g,g,g,r,m,m,m,m,m,r,m,m,m,n,m,m,m,m,r,m,m,r,m,n,r,m,w
w,r,r,r,r,r,r,r,2,r,r,r,r,r,r,r,r,r,r,a,r,r,r,r,r,r,r,r,r,g,b,g,t,g,b,g,r,r,r,r,r,r,r,r,r,r,r,a,r,r,r,r,m,m,r,m,m,a,m,w
w,r,m,m,r,m,m,m,m,m,r,m,n,r,m,m,r,m,m,m,r,m,m,r,m,m,n,m,r,g,g,g,g,g,g,g,r,m,m,m,m,m,m,m,m,m,m,m,m,n,m,r,m,m,r,m,m,r,m,w
w,r,m,m,r,m,m,m,m,m,r,m,m,r,m,m,r,m,g,n,r,m,m,r,m,g,g,g,r,r,g,g,t,g,g,r,r,g,g,g,g,g,m,n,m,m,m,m,m,m,m,r,m,m,r,m,m,r,m,w
w,r,m,m,r,m,m,r,r,r,r,m,m,r,m,m,r,m,g,m,r,n,m,r,m,g,g,g,g,r,a,g,g,g,1,r,g,g,g,g,g,m,a,r,r,r,r,r,r,r,r,r,m,m,r,m,m,r,m,w
w,r,m,m,r,m,m,r,g,g,g,g,m,r,m,m,r,m,g,m,r,m,m,r,m,g,g,g,g,g,r,r,r,r,r,g,g,g,g,g,g,m,r,m,m,m,m,m,m,m,m,r,n,m,r,m,m,r,m,w
w,r,m,n,r,n,m,r,g,g,g,g,m,r,n,m,r,m,g,m,r,m,m,r,m,m,m,m,m,m,g,m,r,m,g,g,g,g,g,g,g,m,r,m,g,g,m,m,m,m,m,r,r,r,r,r,r,r,m,w
w,r,m,m,r,r,r,r,g,g,g,g,m,r,m,m,r,m,g,m,r,m,m,r,r,r,r,r,r,r,m,m,r,n,g,r,r,r,r,r,r,r,r,m,g,r,r,r,r,r,r,r,m,m,m,m,m,r,m,w
w,r,m,m,r,m,m,m,g,g,g,g,m,r,m,m,r,m,g,m,r,m,m,r,m,n,m,m,m,r,m,m,r,m,g,r,m,m,m,r,p,p,r,m,m,r,m,m,m,m,m,m,g,g,g,g,m,r,m,w
w,r,m,m,r,m,m,m,m,m,m,m,m,r,m,m,r,m,m,m,r,m,m,r,m,m,m,m,m,r,m,m,r,m,g,r,m,g,m,r,p,e,r,n,m,r,m,m,m,m,m,m,g,g,g,g,m,r,n,w
w,r,r,r,r,r,r,r,r,r,r,r,r,r,r,r,r,r,r,r,r,r,r,r,r,r,r,r,r,r,r,r,r,m,g,r,m,g,m,r,p,p,a,m,m,r,r,r,r,r,r,r,m,g,g,g,m,r,m,w
w,m,r,m,m,m,m,m,m,r,m,m,m,m,m,m,r,m,m,m,r,m,m,m,m,m,r,m,m,m,m,n,r,m,g,r,m,g,m,r,p,p,r,m,m,m,m,r,n,m,m,r,m,g,g,g,m,r,m,w
w,m,r,m,g,g,g,g,m,r,n,g,g,g,g,m,r,m,t,m,r,n,m,m,m,m,r,m,m,m,m,m,r,m,g,r,n,g,m,r,d,p,r,m,t,t,m,r,m,b,m,r,m,g,g,g,m,r,m,w
w,m,r,m,m,m,m,m,m,r,m,m,m,m,m,m,r,m,t,m,a,r,r,r,r,r,r,r,r,r,r,r,r,m,m,a,m,m,m,r,r,r,r,m,t,t,m,r,m,t,m,r,m,g,g,g,m,r,m,w
w,m,r,r,r,r,r,r,r,r,r,r,r,r,r,r,a,m,b,m,r,m,m,m,m,m,r,m,m,m,m,m,r,m,r,r,r,r,r,r,m,m,r,m,t,t,m,a,m,t,m,r,m,g,g,g,m,r,m,w
w,m,r,m,m,m,m,m,m,m,m,n,m,m,m,m,r,n,t,m,r,m,m,m,m,m,r,m,m,n,m,m,r,r,r,m,m,m,m,m,m,m,r,m,m,m,m,r,m,m,m,r,n,m,m,m,m,r,m,w
w,m,r,m,m,m,m,m,m,m,m,m,m,m,m,m,r,m,b,m,r,r,r,r,r,r,r,r,r,r,r,a,r,m,r,m,m,m,g,g,g,m,r,r,r,r,r,r,r,r,r,r,r,r,a,r,r,r,m,w
w,m,r,r,r,r,r,r,r,r,r,r,r,r,r,r,r,m,t,m,r,m,m,m,m,m,m,m,m,m,m,m,m,m,r,r,r,r,m,g,g,m,r,m,m,m,m,m,m,m,m,m,m,m,n,m,m,r,m,w
w,m,r,m,m,m,n,m,m,m,r,m,m,m,m,m,m,m,g,r,r,r,g,g,g,g,g,g,g,g,m,m,n,m,r,m,m,r,m,m,m,m,r,m,m,m,m,m,m,m,m,m,m,m,m,m,m,r,m,w
w,m,r,m,m,m,m,m,m,m,r,n,m,m,m,m,m,m,r,r,g,r,r,m,m,m,m,g,m,r,r,r,r,r,r,m,m,r,r,r,r,r,r,r,r,r,r,r,r,r,r,r,r,r,r,r,r,r,m,w
w,r,r,r,r,r,r,r,a,r,r,r,r,r,r,r,r,r,r,g,b,g,r,r,r,r,r,m,m,r,m,m,m,m,r,n,m,r,m,g,g,g,g,m,r,c,p,p,p,r,m,m,m,n,m,m,m,r,m,w
w,r,m,m,r,m,m,r,m,m,m,m,m,r,m,m,m,m,r,r,g,a,r,n,m,m,r,m,m,r,m,g,g,m,r,m,m,r,m,m,m,m,m,m,r,p,p,p,p,r,m,m,m,m,m,m,m,r,m,w
w,r,m,m,r,m,m,r,n,g,g,g,m,r,m,g,g,g,g,r,r,r,g,g,g,m,r,m,m,r,m,g,g,m,r,m,m,r,r,r,r,r,r,r,r,r,r,r,r,r,r,r,r,r,r,r,r,r,m,w
w,r,m,m,r,m,m,r,m,m,m,m,m,r,m,g,g,g,g,n,r,m,g,g,g,m,r,m,m,r,m,g,g,m,r,m,m,r,m,m,m,m,m,m,m,m,r,m,m,m,m,m,m,m,m,m,m,r,n,w
w,r,g,g,r,g,g,r,r,r,r,r,r,r,m,g,g,g,g,m,r,m,g,g,g,m,r,m,m,r,m,g,g,m,r,m,m,r,m,m,m,m,m,m,m,n,r,m,m,m,m,m,n,m,m,m,m,r,m,w
w,r,g,g,r,g,g,r,m,m,m,m,m,r,m,g,m,m,m,m,r,m,m,m,m,m,r,m,m,r,m,m,m,m,r,r,r,r,r,r,r,a,r,r,r,r,r,r,r,r,a,r,r,r,r,r,r,r,m,w
w,r,m,m,a,n,m,r,m,m,m,m,m,r,m,m,r,r,r,r,r,r,r,r,r,r,r,r,r,r,r,r,r,r,r,m,m,r,m,n,m,m,m,m,m,m,r,m,n,m,m,m,m,m,r,m,m,r,m,w
w,r,m,m,r,m,m,r,r,r,r,r,r,a,r,r,r,m,m,m,r,m,m,m,m,m,r,m,m,m,m,m,m,m,a,n,m,r,m,g,g,g,g,g,g,m,r,m,g,g,g,g,g,m,r,m,m,r,m,w
w,r,m,m,r,m,m,r,m,m,m,n,m,r,n,m,m,g,g,m,r,m,g,g,g,m,r,m,m,m,n,m,m,m,r,m,m,r,m,g,g,g,g,g,r,r,r,r,r,g,g,g,g,m,r,m,n,r,m,w
w,r,r,r,r,r,r,r,m,m,m,m,m,r,m,g,g,g,g,m,r,m,g,g,g,m,r,r,r,r,r,r,r,r,r,m,m,r,m,g,g,g,g,r,r,g,g,g,a,r,g,g,g,m,r,m,m,r,m,w
w,m,m,m,r,c,p,r,r,r,r,m,m,r,m,g,g,g,g,r,r,r,g,g,g,n,r,m,m,m,m,m,m,m,r,m,m,r,m,g,g,g,r,r,g,g,b,g,g,r,r,g,g,n,r,m,m,r,m,w
w,m,r,a,r,p,g,g,m,m,r,m,m,r,m,m,m,m,r,r,g,r,r,m,m,m,r,m,m,m,m,m,m,m,r,m,m,r,m,m,m,m,r,g,g,g,g,g,g,g,r,m,m,m,r,m,m,r,m,w
w,m,r,n,r,r,g,g,g,m,r,r,r,r,r,r,r,r,r,g,t,g,r,r,r,r,r,r,r,r,r,r,r,r,r,r,r,r,r,r,r,r,r,g,t,g,t,g,b,g,r,r,r,r,a,r,r,r,m,w
w,m,r,m,m,r,m,g,g,m,r,c,p,p,r,m,m,m,r,r,g,r,r,m,m,m,r,m,m,r,m,m,m,m,a,t,t,t,b,r,m,m,r,g,g,g,g,g,g,g,r,m,m,m,r,m,m,r,m,w
w,m,r,m,m,r,m,g,g,m,a,p,b,p,r,m,g,g,g,r,r,r,g,g,g,m,r,m,m,r,n,m,m,m,r,t,t,t,t,r,m,m,r,r,g,g,t,g,g,r,r,g,g,m,r,m,n,r,m,w
w,m,r,m,m,r,m,g,g,n,r,p,t,p,r,m,g,m,g,m,r,m,g,m,n,m,r,m,m,r,r,r,r,r,r,t,t,b,t,r,m,g,g,r,r,g,g,g,r,r,g,g,g,m,r,m,m,r,m,w
w,m,r,m,m,r,m,g,g,m,r,p,t,p,r,m,m,r,m,m,r,m,m,r,r,r,r,m,m,a,m,m,r,g,r,t,t,t,n,r,m,g,g,g,r,r,r,r,r,g,g,g,g,m,r,m,m,r,n,w
w,m,r,m,m,r,m,m,m,m,r,p,t,p,r,m,m,r,m,m,r,m,g,m,m,m,r,m,m,r,m,m,r,g,r,r,r,r,r,r,m,g,g,g,g,m,r,m,g,g,g,g,g,m,r,m,m,r,m,w
w,m,a,m,m,r,r,r,r,r,r,r,p,d,r,m,m,r,m,m,r,m,b,t,t,t,r,m,n,r,m,m,r,g,m,m,n,m,m,a,m,g,g,g,g,m,r,m,g,g,g,g,g,m,r,n,m,r,m,w
w,n,r,m,m,m,m,m,m,m,m,r,r,r,r,r,r,r,r,r,r,r,r,r,r,r,r,m,m,r,m,m,r,g,g,g,g,g,m,r,m,g,g,g,g,m,r,m,g,g,g,g,g,m,r,m,m,r,m,w
w,m,r,m,g,g,g,g,g,g,g,m,r,t,r,m,m,r,n,m,a,m,m,r,m,m,r,m,m,r,m,m,r,m,m,m,m,m,m,r,m,m,m,m,m,m,r,n,m,m,m,m,m,m,r,m,m,r,m,w
w,m,3,m,g,g,g,g,g,g,g,m,r,t,r,m,m,r,m,m,r,m,m,r,m,m,r,m,m,r,m,m,r,r,r,r,r,r,a,r,r,r,r,4,r,r,r,r,a,r,r,r,r,r,r,r,r,r,m,w
w,m,r,m,g,g,g,g,g,g,g,m,r,t,r,m,m,r,m,m,r,n,m,r,m,n,r,m,m,r,m,m,m,m,m,m,m,n,r,m,m,m,m,m,m,m,r,m,m,m,m,m,m,n,m,m,m,r,m,w
w,m,r,m,m,m,m,m,m,m,m,m,r,b,r,m,m,r,m,m,r,m,m,r,m,m,r,m,m,r,m,m,m,m,m,m,m,m,r,m,m,m,m,m,m,n,r,m,m,m,m,m,m,m,m,m,m,r,m,w
w,m,r,r,r,r,r,r,r,r,r,r,r,a,r,r,r,r,r,r,r,r,r,r,r,r,r,r,r,r,r,r,r,r,r,r,r,r,r,r,r,r,r,r,r,r,r,r,r,r,r,r,r,r,r,r,r,r,m,w
w,w,m,m,h,m,m,m,m,m,m,m,m,n,m,m,m,m,n,m,m,m,m,m,m,m,m,m,m,m,n,m,m,m,m,m,m,m,m,m,m,m,m,m,m,m,m,m,m,m,m,n,m,m,m,m,m,m,w,w
w,w,w,w,w,w,w,w,w,w,w,w,w,w,w,w,w,w,w,w,w,w,w,w,w,w,w,w,w,w,w,w,w,w,w,w,w,w,w,w,w,w,w,w,w,w,w,w,w,w,w,w,w,w,w,w,w,w,w,w
